{
    "64": 1,
    "65": 1,
    "66": 1,
    "67": 1,
    "72": 1,
    "73": 1,
    "74": 1,
    "75": 1,
    "76": 1,
    "77": 1,
    "78": 1,
    "79": 1,
    "80": 1,
    "81": 1,
    "82": 1,
    "92": 1,
    "93": 1,
    "94": 1,
    "95": 1,
    "63": 2,
    "71": 3,
    "91": 4,
    "100": 5,
    "11": 7,
    "12": 6,
    "13": 6,
    "14": 6,
    "15": 6,
    "16": 6,
    "17": 6,
    "21": 6,
    "22": 6,
    "23": 6,
    "24": 6,
    "25": 6,
    "26": 6,
    "27": 6,
    "28": 6,
    "29": 6,
    "30": 6,
    "31": 6,
    "32": 6,
    "41": 6,
    "42": 6,
    "43": 6,
    "44": 6,
    "45": 6,
    "50": 6,
    "2": 8,
    "1": 9
}