{
    "64": 1,
    "65": 1,
    "66": 1,
    "67": 1,
    "72": 1,
    "73": 1,
    "74": 1,
    "75": 1,
    "76": 1,
    "77": 1,
    "78": 1,
    "79": 1,
    "80": 1,
    "81": 1,
    "82": 1,
    "92": 1,
    "93": 1,
    "94": 1,
    "95": 1,
    "63": 2,
    "71": 3,
    "91": 4,
    "100": 5,
    "12": 7,
    "14": 7,
    "16": 7,
    "21": 7,
    "23": 7,
    "25": 7,
    "27": 7,
    "29": 7,
    "31": 7,
    "41": 7,
    "43": 7,
    "45": 7,
    "11": 8,
    "13": 8,
    "15": 8,
    "17": 8,
    "22": 8,
    "24": 8,
    "26": 8,
    "28": 8,
    "30": 8,
    "32": 8,
    "42": 8,
    "44": 8,
    "50": 9,
    "2": 10,
    "1": 11
}