{
    "63": 3,
    "64": 4,
    "65": 5,
    "66": 6,
    "67": 7,
    "71": 8,
    "72": 10,
    "73": 11,
    "74": 12,
    "75": 13,
    "76": 14,
    "77": 15,
    "78": 16,
    "79": 17,
    "80": 18,
    "81": 19,
    "82": 20,
    "91": 21,
    "92": 23,
    "93": 24,
    "94": 25,
    "95": 26,
    "100": 27,
    "11": 30,
    "12": 31,
    "13": 32,
    "14": 33,
    "15": 34,
    "16": 35,
    "17": 36,
    "21": 38,
    "22": 39,
    "23": 40,
    "24": 41,
    "25": 42,
    "26": 43,
    "27": 44,
    "28": 45,
    "29": 46,
    "30": 47,
    "31": 48,
    "32": 49,
    "41": 51,
    "42": 52,
    "43": 53,
    "44": 54,
    "45": 55,
    "50": 56,
    "1": 58,
    "2": 57
}