{
    "18": 9,
    "19": 10,
    "20": 9,
    "21": 10,
    "22": 9,
    "23": 13,
    "24": 9,
    "25": 10,
    "26": 9,
    "27": 10,
    "28": 9,
    "29": 10,
    "30": 9,
    "31": 10,
    "32": 9,
    "33": 10,
    "34": 12,
    "35": 10,
    "36": 9,
    "37": 10,
    "38": 9,
    "39": 10,
    "40": 11,
    "41": 10,
    "92": 14,
    "200": 17,
    "201": 16,
    "202": 7,
    "203": 2,
    "204": 3,
    "205": 2,
    "206": 3,
    "207": 6,
    "208": 3,
    "209": 2,
    "210": 3,
    "211": 2,
    "212": 3,
    "213": 2,
    "214": 3,
    "215": 2,
    "216": 3,
    "217": 2,
    "218": 3,
    "219": 5,
    "220": 3,
    "221": 2,
    "222": 3,
    "223": 2,
    "224": 4
}