{
    "64": 1,
    "65": 1,
    "66": 1,
    "67": 1,
    "72": 1,
    "73": 1,
    "74": 1,
    "75": 1,
    "76": 1,
    "77": 1,
    "78": 1,
    "79": 1,
    "80": 1,
    "81": 1,
    "82": 1,
    "92": 1,
    "93": 1,
    "94": 1,
    "95": 1,
    "63": 2,
    "71": 3,
    "91": 4,
    "100": 5,
    "11": 7,
    "13": 7,
    "15": 7,
    "17": 7,
    "22": 7,
    "24": 7,
    "26": 7,
    "28": 7,
    "30": 7,
    "32": 7,
    "42": 7,
    "44": 7,
    "12": 8,
    "14": 8,
    "16": 8,
    "21": 8,
    "23": 8,
    "25": 8,
    "27": 8,
    "29": 8,
    "31": 8,
    "41": 8,
    "43": 8,
    "45": 8,
    "50": 9,
    "2": 10,
    "1": 11
}