{
    "18": 10,
    "19": 9,
    "20": 10,
    "21": 9,
    "22": 10,
    "23": 13,
    "24": 10,
    "25": 9,
    "26": 10,
    "27": 9,
    "28": 10,
    "29": 9,
    "30": 10,
    "31": 9,
    "32": 10,
    "33": 9,
    "34": 12,
    "35": 9,
    "36": 10,
    "37": 9,
    "38": 10,
    "39": 9,
    "40": 11,
    "41": 9,
    "92": 14,
    "200": 17,
    "201": 16,
    "202": 7,
    "203": 3,
    "204": 2,
    "205": 3,
    "206": 2,
    "207": 6,
    "208": 2,
    "209": 3,
    "210": 2,
    "211": 3,
    "212": 2,
    "213": 3,
    "214": 2,
    "215": 3,
    "216": 2,
    "217": 3,
    "218": 2,
    "219": 5,
    "220": 2,
    "221": 3,
    "222": 2,
    "223": 3,
    "224": 4
}